111111111111
10000011DCD1
1PE110000001
1DC000D111C1
111111111111